#
# psql -h helsten.dsl.xmission.com -d lossrecovery
# -c "select alpha2,alpha3,name from oft_ref.iso3166
#       where lang='en' order by alpha2"
# -o ISO3166.txt 

 AC     |        | Ascension Island
 AD     | AND    | Andorra
 AE     | ARE    | United Arab Emirates
 AF     | AFG    | Afghanistan
 AG     | ATG    | Antigua and Barbuda
 AI     | AIA    | Anguilla
 AL     | ALB    | Albania
 AM     | ARM    | Armenia
 AN     | ANT    | Netherlands Antilles
 AO     | AGO    | Angola
 AP     |        | 
 AQ     | ATA    | Antarctica
 AR     | ARG    | Argentina
 AS     | ASM    | American Samoa
 AT     | AUT    | Austria
 AU     | AUS    | Australia
 AW     | ABW    | Aruba
 AX     | ALA    | Åland Islands
 AZ     | AZE    | Azerbaijan
 BA     | BIH    | Bosnia and Herzegovina
 BB     | BRB    | Barbados
 BD     | BGD    | Bangladesh
 BE     | BEL    | Belgium
 BF     | BFA    | Burkina Faso
 BG     | BGR    | Bulgaria
 BH     | BHR    | Bahrain
 BI     | BDI    | Burundi
 BJ     | BEN    | Benin
 BM     | BMU    | Bermuda
 BN     | BRN    | Brunei Darussalam
 BO     | BOL    | Bolivia
 BR     | BRA    | Brazil
 BS     | BHS    | Bahamas
 BT     | BTN    | Bhutan
 BU     |        | Burma
 BV     | BVT    | Bouvet Island
 BW     | BWA    | Botswana
 BX     |        | 
 BY     | BLR    | Belarus
 BZ     | BLZ    | Belize
 CA     | CAN    | Canada
 CC     | CCK    | Cocos (Keeling) Islands
 CD     | COD    | Congo, the Democratic Republic of the
 CF     | CAF    | Central African Republic
 CG     | COG    | Congo
 CH     | CHE    | Switzerland
 CI     | CIV    | Côte d'Ivoire
 CK     | COK    | Cook Islands
 CL     | CHL    | Chile
 CM     | CMR    | Cameroon
 CN     | CHN    | China
 CO     | COL    | Colombia
 CP     |        | Clipperton Island
 CR     | CRI    | Costa Rica
 CS     | SCG    | Serbia and Montenegro
 CU     | CUB    | Cuba
 CV     | CPV    | Cape Verde
 CX     | CXR    | Christmas Island
 CY     | CYP    | Cyprus
 CZ     | CZE    | Czech Republic
 DE     | DEU    | Germany
 DG     |        | Diego Garcia
 DJ     | DJI    | Djibouti
 DK     | DNK    | Denmark
 DM     | DMA    | Dominica
 DO     | DOM    | Dominican Republic
 DY     |        | Benin
 DZ     | DZA    | Algeria
 EA     |        | Ceuta, Melilla
 EC     | ECU    | Ecuador
 EE     | EST    | Estonia
 EF     |        | 
 EG     | EGY    | Egypt
 EH     | ESH    | Western Sahara
 EM     |        | 
 EP     |        | 
 ER     | ERI    | Eritrea
 ES     | ESP    | Spain
 ET     | ETH    | Ethiopia
 EU     |        | European Union
 EV     |        | 
 EW     |        | Estonia
 FI     | FIN    | Finland
 FJ     | FJI    | Fiji
 FK     | FLK    | Falkland Islands (Malvinas)
 FL     |        | Liechtenstein
 FM     | FSM    | Micronesia
 FO     | FRO    | Faroe Islands
 FR     | FRA    | France
 FX     |        | France, Metropolitan
 GA     | GAB    | Gabon
 GB     | GBR    | United Kingdom
 GC     |        | 
 GD     | GRD    | Grenada
 GE     | GEO    | Georgia
 GF     | GUF    | French Guiana
 GG     |        | Guernsey
 GH     | GHA    | Ghana
 GI     | GIB    | Gibraltar
 GL     | GRL    | Greenland
 GM     | GMB    | Gambia
 GN     | GIN    | Guinea
 GP     | GLP    | Guadeloupe
 GQ     | GNQ    | Equatorial Guinea
 GR     | GRC    | Greece
 GS     | SGS    | South Georgia and the South Sandwich Islands
 GT     | GTM    | Guatemala
 GU     | GUM    | Guam
 GW     | GNB    | Guinea-Bissau
 GY     | GUY    | Guyana
 HK     | HKG    | Hong Kong
 HM     | HMD    | Heard Island and McDonald Islands
 HN     | HND    | Honduras
 HR     | HRV    | Croatia
 HT     | HTI    | Haiti
 HU     | HUN    | Hungary
 IB     |        | 
 IC     |        | Canary Islands
 ID     | IDN    | Indonesia
 IE     | IRL    | Ireland
 IL     | ISR    | Israel
 IM     |        | Isle of Man
 IN     | IND    | India
 IO     | IOT    | British Indian Ocean Territory
 IQ     | IRQ    | Iraq
 IR     | IRN    | Iran, Islamic Republic of
 IS     | ISL    | Iceland
 IT     | ITA    | Italy
 JA     |        | Jamaica
 JE     |        | Jersey
 JM     | JAM    | Jamaica
 JO     | JOR    | Jordan
 JP     | JPN    | Japan
 KE     | KEN    | Kenya
 KG     | KGZ    | Kyrgyzstan
 KH     | KHM    | Cambodia
 KI     | KIR    | Kiribati
 KM     | COM    | Comoros
 KN     | KNA    | Saint Kitts and Nevis
 KP     | PRK    | Korea, Democratic People's Republic of
 KR     | KOR    | Korea, Republic of
 KW     | KWT    | Kuwait
 KY     | CYM    | Cayman Islands
 KZ     | KAZ    | Kazakhstan
 LA     | LAO    | Lao People's Democratic Republic
 LB     | LBN    | Lebanon
 LC     | LCA    | Saint Lucia
 LF     |        | Libya Fezzan
 LI     | LIE    | Liechtenstein
 LK     | LKA    | Sri Lanka
 LR     | LBR    | Liberia
 LS     | LSO    | Lesotho
 LT     | LTU    | Lithuania
 LU     | LUX    | Luxembourg
 LV     | LVA    | Latvia
 LY     | LBY    | Libyan Arab Jamahiriya
 MA     | MAR    | Morocco
 MC     | MCO    | Monaco
 MD     | MDA    | Moldova, Republic of
 MG     | MDG    | Madagascar
 MH     | MHL    | Marshall Islands
 MK     | MKD    | Macedonia, the Former Yugoslav Republic of
 ML     | MLI    | Mali
 MM     | MMR    | Myanmar
 MN     | MNG    | Mongolia
 MO     | MAC    | Macao
 MP     | MNP    | Northern Mariana Islands
 MQ     | MTQ    | Martinique
 MR     | MRT    | Mauritania
 MS     | MSR    | Montserrat
 MT     | MLT    | Malta
 MU     | MUS    | Mauritius
 MV     | MDV    | Maldives
 MW     | MWI    | Malawi
 MX     | MEX    | Mexico
 MY     | MYS    | Malaysia
 MZ     | MOZ    | Mozambique
 NA     | NAM    | Namibia
 NC     | NCL    | New Caledonia
 NE     | NER    | Niger
 NF     | NFK    | Norfolk Island
 NG     | NGA    | Nigeria
 NI     | NIC    | Nicaragua
 NL     | NLD    | Netherlands
 NO     | NOR    | Norway
 NP     | NPL    | Nepal
 NR     | NRU    | Nauru
 NT     |        | Neutral Zone
 NU     | NIU    | Niue
 NZ     | NZL    | New Zealand
 OM     | OMN    | Oman
 PA     | PAN    | Panama
 PE     | PER    | Peru
 PF     | PYF    | French Polynesia
 PG     | PNG    | Papua New Guinea
 PH     | PHL    | Philippines
 PI     |        | Philippines
 PK     | PAK    | Pakistan
 PL     | POL    | Poland
 PM     | SPM    | Saint Pierre and Miquelon
 PN     | PCN    | Pitcairn
 PR     | PRI    | Puerto Rico
 PS     | PSE    | Palestinian Territory, Occupied
 PT     | PRT    | Portugal
 PW     | PLW    | Palau
 PY     | PRY    | Paraguay
 QA     | QAT    | Qatar
 RA     |        | Argentina
 RB     |        | Bolivia
 RC     |        | China
 RE     | REU    | Réunion
 RH     |        | Haiti
 RI     |        | Indonesia
 RL     |        | Lebanon
 RM     |        | Madagascar
 RN     |        | Niger
 RO     | ROU    | Romania
 RP     |        | Philippines
 RU     | RUS    | Russian Federation
 RW     | RWA    | Rwanda
 SA     | SAU    | Saudi Arabia
 SB     | SLB    | Solomon Islands
 SC     | SYC    | Seychelles
 SD     | SDN    | Sudan
 SE     | SWE    | Sweden
 SF     |        | Finland
 SG     | SGP    | Singapore
 SH     | SHN    | Saint Helena
 SI     | SVN    | Slovenia
 SJ     | SJM    | Svalbard and Jan Mayen
 SK     | SVK    | Slovakia
 SL     | SLE    | Sierra Leone
 SM     | SMR    | San Marino
 SN     | SEN    | Senegal
 SO     | SOM    | Somalia
 SR     | SUR    | Suriname
 ST     | STP    | Sao Tome and Principe
 SU     |        | USSR
 SV     | SLV    | El Salvador
 SY     | SYR    | Syrian Arab Republic
 SZ     | SWZ    | Swaziland
 TA     |        | Tristan da Cunha
 TC     | TCA    | Turks and Caicos Islands
 TD     | TCD    | Chad
 TF     | ATF    | French Southern Territories
 TG     | TGO    | Togo
 TH     | THA    | Thailand
 TJ     | TJK    | Tajikistan
 TK     | TKL    | Tokelau
 TL     | TLS    | Timor-Leste
 TM     | TKM    | Turkmenistan
 TN     | TUN    | Tunisia
 TO     | TON    | Tonga
 TP     |        | East Timor
 TR     | TUR    | Turkey
 TT     | TTO    | Trinidad and Tobago
 TV     | TUV    | Tuvalu
 TW     | TWN    | Taiwan, Province of China
 TZ     | TZA    | Tanzania, United Republic Of
 UA     | UKR    | Ukraine
 UG     | UGA    | Uganda
 UK     |        | United Kingdom
 UM     | UMI    | United States Minor Outlying Islands
 US     | USA    | United States
 UY     | URY    | Uruguay
 UZ     | UZB    | Uzbekistan
 VA     | VAT    | Holy See (Vatican City State)
 VC     | VCT    | Saint Vincent and the Grenadines
 VE     | VEN    | Venezuela
 VG     | VGB    | Virgin Islands, British
 VI     | VIR    | Virgin Islands, U.S.
 VN     | VNM    | Viet Nam
 VU     | VUT    | Vanuatu
 WF     | WLF    | Wallis and Futuna
 WG     |        | Grenada
 WL     |        | Saint Lucia
 WO     |        | 
 WS     | WSM    | Samoa
 WV     |        | Saint Vincent
 YE     | YEM    | Yemen
 YT     | MYT    | Mayotte
 YV     |        | Venezuela
 ZA     | ZAF    | South Africa
 ZM     | ZMB    | Zambia
 ZR     |        | Yugoslavia
 ZW     | ZWE    | Zimbabwe

